"filename", "language", "Rust", "TOML", "Markdown", "comment", "blank", "total"
"/Users/tianyishi/Documents/GitHub/Algorithms/Cargo.toml", "TOML", 0, 10, 0, 1, 3, 14
"/Users/tianyishi/Documents/GitHub/Algorithms/README.md", "Markdown", 0, 0, 41, 0, 24, 65
"/Users/tianyishi/Documents/GitHub/Algorithms/benches/bfs.rs", "Rust", 0, 0, 0, 0, 2, 2
"/Users/tianyishi/Documents/GitHub/Algorithms/src/algo.rs", "Rust", 2, 0, 0, 0, 1, 3
"/Users/tianyishi/Documents/GitHub/Algorithms/src/algo/graph.rs", "Rust", 75, 0, 0, 10, 8, 93
"/Users/tianyishi/Documents/GitHub/Algorithms/src/algo/graph/bfs.rs", "Rust", 2, 0, 0, 0, 1, 3
"/Users/tianyishi/Documents/GitHub/Algorithms/src/algo/graph/bfs/iterative.rs", "Rust", 81, 0, 0, 6, 11, 98
"/Users/tianyishi/Documents/GitHub/Algorithms/src/algo/graph/bfs/recursive.rs", "Rust", 0, 0, 0, 0, 1, 1
"/Users/tianyishi/Documents/GitHub/Algorithms/src/algo/graph/dfs.rs", "Rust", 1, 0, 0, 0, 1, 2
"/Users/tianyishi/Documents/GitHub/Algorithms/src/algo/graph/dfs/iterative.rs", "Rust", 63, 0, 0, 20, 13, 96
"/Users/tianyishi/Documents/GitHub/Algorithms/src/algo/graph/tree.rs", "Rust", 7, 0, 0, 0, 1, 8
"/Users/tianyishi/Documents/GitHub/Algorithms/src/algo/graph/tree/center.rs", "Rust", 68, 0, 0, 11, 10, 89
"/Users/tianyishi/Documents/GitHub/Algorithms/src/algo/graph/tree/height.rs", "Rust", 51, 0, 0, 14, 7, 72
"/Users/tianyishi/Documents/GitHub/Algorithms/src/algo/graph/tree/height1.rs", "Rust", 78, 0, 0, 15, 10, 103
"/Users/tianyishi/Documents/GitHub/Algorithms/src/algo/graph/tree/isomorphism.rs", "Rust", 75, 0, 0, 6, 8, 89
"/Users/tianyishi/Documents/GitHub/Algorithms/src/algo/graph/tree/rooting.rs", "Rust", 100, 0, 0, 18, 6, 124
"/Users/tianyishi/Documents/GitHub/Algorithms/src/algo/graph/tree/rooting1.rs", "Rust", 78, 0, 0, 12, 7, 97
"/Users/tianyishi/Documents/GitHub/Algorithms/src/algo/graph/tree/sum.rs", "Rust", 66, 0, 0, 10, 11, 87
"/Users/tianyishi/Documents/GitHub/Algorithms/src/algo/math.rs", "Rust", 2, 0, 0, 0, 1, 3
"/Users/tianyishi/Documents/GitHub/Algorithms/src/algo/math/gcd.rs", "Rust", 31, 0, 0, 0, 4, 35
"/Users/tianyishi/Documents/GitHub/Algorithms/src/algo/math/lcm.rs", "Rust", 19, 0, 0, 0, 3, 22
"/Users/tianyishi/Documents/GitHub/Algorithms/src/data_structures.rs", "Rust", 1, 0, 0, 0, 1, 2
"/Users/tianyishi/Documents/GitHub/Algorithms/src/data_structures/queue.rs", "Rust", 64, 0, 0, 6, 6, 76
"/Users/tianyishi/Documents/GitHub/Algorithms/src/lib.rs", "Rust", 3, 0, 0, 0, 1, 4
"/Users/tianyishi/Documents/GitHub/Algorithms/src/problems.rs", "Rust", 2, 0, 0, 0, 1, 3
"/Users/tianyishi/Documents/GitHub/Algorithms/src/problems/backtracking.rs", "Rust", 2, 0, 0, 0, 1, 3
"/Users/tianyishi/Documents/GitHub/Algorithms/src/problems/backtracking/nqueens.rs", "Rust", 134, 0, 0, 9, 13, 156
"/Users/tianyishi/Documents/GitHub/Algorithms/src/problems/backtracking/sudoku.rs", "Rust", 171, 0, 0, 21, 18, 210
"/Users/tianyishi/Documents/GitHub/Algorithms/src/problems/dp.rs", "Rust", 1, 0, 0, 0, 1, 2
"/Users/tianyishi/Documents/GitHub/Algorithms/src/problems/dp/edit_distance.rs", "Rust", 0, 0, 0, 0, 1, 1
"Total", "-", 1177, 10, 41, 159, 176, 1563